



1111111111111111111111111111111

1E0000000CC0000C0000C0000000001
101001010010000010101000E010101
1010010010101010000010000010101


1P0000000C00C0000000000000000C1


1111111111111111111111111111111