1111111111111111111111111111111
1E0000000CC0000C0000C0G00000001
1010010100100000101010000010101
1010010010101010000010000010101
1P0000000C00C00000000000G0000C1
1111111111111111111111111111111